11111111111111
10000000000001
1000000000CPE1
11111111111111