1111111111111111111111111111
1000000000000111111111111111
10000000000001
1000000000CPE111111111111111
10000000000001
1000000000CPE1
1111111111111111111111111111
10000000000001
1000000000CPE1
1111111111111111111111111111
10000000000001
1000000000CPE1
1111111111111111111111111111
10000000000001
1000000000CPE1
1111111111111111111111111111
10000000000001
1000000000CPE1
11111111111111
11111111111111
1000000000CPE1
1111111111111111111111111111
10000000000001
1000000000CPE1
1111111111111111111111111111
10000000000001
1000000000CPE1
1111111111111111111111111111
10000000000001
1000000000CPE1
1111111111111111111111111111
10000000000001
1000000000CPE1
1111111111111111111111111111
10000000000001
1000000000CPE1
1111111111111111111111111111
10000000000001
1000000000CPE1
1111111111111111111111111111
10000000000001
1000000000CPE1
1111111111111111111111111111
10000000000001
1000000000CPE1
1111111111111111111111111111
10000000000001
1000000000CPE1
11111111111111
10000000000001
1000000000CPE1
11111111111111