11111111111111
1000C000000001
100CC11000CCC1
1111CCCC11C111
11111E11C00111
10000000C11111
1P111C11111101
11111111111111